500 500
10 50 90 50 
7
 20 40 20 20 80 20 80 40 79 40 79 21 21 21 21 40
 20 80 20 60 21 60 21 79 79 79 79 50 80 50 80 80
 30 54 30 21 34 21 34 54
 40 79 40 60 44 60 44 79
 40 37 40 33 70 33 70 37
 60 79 60 58 77 58 77 79
 40 50 40 40 70 40 70 50