500 500
20 50 90 50
7
 24 54 25 50 45 50 45 54
 40 54 45 54 45 74 40 74 
 20 74 21 70 40 70 40 74
 77 50 80 50 80 70 90 70 90 75 76 74
 55 90 57 69 62 69 64 89
 58 62 55 45 61 45 64 62
 55 37 54 15 62 14 63 38
