500 500
10 50 90 50 
9
 20 40 20 20 80 20 80 40 79 40 79 21 21 21 21 40
 20 80 20 60 21 60 21 79 79 79 79 60 80 60 80 80
 25 55 25 45 32 45 32 55 
 40 45 40 21 44 21 44 45
 40 79 40 55 44 55 44 79
 40 37 40 33 70 33 70 37
 50 80 50 60 70 60 70 80
 50 52 50 48 70 48 70 52
 80 52 75 50 80 48 85 50