250 250
20 60 180 100
12
 30 40 44 44 42 62 34 56
 28 76 40 74 42 98 32 96
 100 62 80 60 68 40 124 56
 52 70 60 46 74 66 64 80
 60 90 84 94 84 110 60 112
 88 80 88 70 106 72 106 82
 120 76 130 66 140 80 130 92
 100 108 100 100 134 108 118 122
 140 52 142 38 180 62 176 80
 30 140 36 108 46 106 48 140
 62 140 60 120 100 120 102 142
 130 140 144 110 170 110 160 138
