500 500
10 50 90 60
12
 27 46 23 22 33 23 33 43
 25 65 26 55 32 53 31 64 
 25 95 25 76 35 76 32 96 
 38 18 37 8 47 7 45 18
 47 36 45 25 62 25 61 35
 49 48 50 44 59 44 58 58 49 58 50 54 55 54 56 48
 50 66 49 63 58 62 58 73 49 74 50 71 56 71 56 65
 48 91 47 83 60 83 61 90
 67 22 68 9 77 8 78 18
 70 46 70 29 78 29 79 44
 70 65 70 57 77 57 75 64
 69 87 70 75 77 74 78 86