500 500
12 42 90 42
5
 20 38 20 34 40 34 40 38
 20 50 20 46 40 46 40 50
 45 42 52 38 60 42 52 46
 65 38 65 34 85 34 85 38
 65 50 65 46 85 46 85 50